xxxxxxxxxx3xxxxxxxxx
xxTxxxxxxx0xxxx000cx
xx00000000000000xxxx
xxxxxxxxx0x0xxxxxxxx
x000000cx0x0xT00000x
x0xxxxxxx0x0xxxxxx0x
x000000000x00000000x
xxx0x0xxxxxxx0x0xxxx
xcx0x0xT0x0Tx0x0xT0x
x0x0x0xx0x0xx0x0xx0x
x0x0x0xx0x0xx0x0xx0x
x000x0000x0000x0000x
x0x0x0xx0xx0x0xx0x0x
x0x0x0xx0xx0x0xx0x0x
x0x0x0xx0xx0x0xx0x0x
x0x0x0xx0xx0x0xx0x0x
x0x0x0xx0xx0x0xx0x0x
x0x0x0xx0xx0x0xx0x0x
xTx000xxcxxkxTxx00gx
xxxxxxxxxxxxxxxxxxxx


